....................
r....W..............
...@@@..............
...S..........WWW..R
...@@.........WWW...
..........1...WWW...
...@@....@@...WWW...
....W.........@@@...
............. WWW..R
...@@.......--WWW...
..............WWW...
r...........--WWW...
..............WWW...
.X..A...T.....WWW...
######..###...@@@...
There are many drops in the ocean...
